#.##########
#.##...#####
#.##.#.#####
#....#......
############