#.####################.##
#.##...########........##
#.##.#.########.######.##
#....#......###.######.##
###.##.#.##.........##.##
###.##.#.##.###.#.#.##.##
###.........###.#.#.##.##
###.#.##.##.........##.##
###.#.##.##.###.#.#.##.##
#...............#.#....##
#.####################.##
#...........#........#.##
###.#######.#.##.###.#.##
###.......#...##.......##
#########################